##################################################
#................................................#
#................................................#
#...................C............................#
#................................................#
#....................................B...........#
#................................................#
##################################################